###.##.#.#
###.#..#.#
#####.##.#
####..##.#
###..###.#
###..##.##
